10-iZ
-i--------
----------
-----i----
---i------
------i-i-
------i---
----------
--i----i--
----------
---i------
